4, -4.96998,-0.45,9.72008, 1,1,1, 0,0,0
2, 50,50,0, 100,2.54186e-38,100, 0,0,90
2, 0,0,0, 100,0,0, 90,0,0
2, -100,0,0, 100,0,100, 0,0,0
2, -100,0,100, 100,0,100, 0,0,0
2, 0,50,50, 100,3.1381e-32,100, -90,0,0
2, -100,0,-100, 100,0,100, 0,0,0
2, 0,50,-50, 100,0,100, 90,0,0
2, 0,0,0, 100,100,100, 0,0,0
1, 5,10,0, 1,1,1, 0,0,0
